35 35 35 35 35 35 35 35 35 35 35 35 35 35 35 35 35 35 35 35 35 35 35 35 35 35 35 35 35 35 35 35 35 35 35 35 35 35 35 35 35 35 35 35 35 35 35 35 35 35 
35 32 32 32 32 32 32 32 32 35 35 32 32 32 32 32 32 32 32 32 32 32 32 32 32 32 32 32 32 32 32 35 35 32 32 32 32 32 32 35 35 35 35 32 32 32 32 32 32 35 
35 32 32 35 35 35 35 32 32 35 35 32 32 32 32 32 32 32 35 35 32 35 35 32 32 32 32 32 32 32 32 35 35 32 32 35 35 32 32 35 35 35 35 32 32 35 35 32 32 35 
35 32 32 35 35 32 32 32 32 35 35 32 32 32 35 35 32 32 32 32 32 32 32 32 32 35 35 32 32 32 32 35 35 32 32 35 35 32 32 35 35 35 35 32 32 35 35 32 32 35 
35 32 32 35 35 32 32 35 35 35 35 32 32 32 32 32 35 35 35 35 35 35 35 35 35 32 32 32 32 32 32 35 35 32 32 35 35 32 32 35 35 35 35 32 32 35 35 32 32 35 
35 32 32 35 35 32 32 32 32 35 35 32 32 32 32 32 32 32 32 32 32 32 32 32 32 32 32 32 32 32 32 35 35 32 32 35 35 32 32 35 35 35 35 32 32 35 35 32 32 35 
35 32 32 35 35 35 35 32 32 35 35 35 35 35 35 35 35 35 35 35 35 35 35 35 35 35 35 35 35 32 32 35 35 32 32 35 35 32 32 32 32 32 32 32 32 35 35 32 32 35 
35 32 32 35 35 32 32 32 32 35 35 32 32 32 32 32 32 32 32 32 32 32 32 32 32 32 32 32 32 32 32 35 35 32 32 35 35 35 35 35 35 35 35 35 35 35 35 32 32 35 
35 32 32 35 35 32 32 35 35 35 35 32 32 35 35 35 35 35 35 35 35 35 35 35 35 35 35 35 35 35 35 35 35 32 32 35 35 32 32 32 32 32 32 32 32 32 32 32 32 35 
35 32 32 35 35 32 32 32 32 35 35 32 32 35 35 35 32 32 32 32 32 35 35 35 32 32 32 32 32 32 32 35 35 32 32 35 35 32 32 35 35 35 35 35 35 35 35 35 35 35 
35 32 32 35 35 35 35 32 32 35 35 32 32 35 35 35 32 35 35 35 32 35 35 35 32 35 35 35 32 32 32 35 35 32 32 35 35 32 32 35 35 32 32 32 32 32 32 32 32 35 
35 32 32 35 35 32 32 32 32 35 35 32 32 32 32 32 32 35 35 35 32 32 32 32 32 35 35 35 32 32 32 35 35 32 32 35 35 32 32 35 35 32 32 32 35 35 32 32 32 35 
35 32 32 35 35 32 32 35 35 35 35 35 35 35 35 35 35 35 35 35 35 35 35 35 35 35 35 35 35 32 32 35 35 32 32 35 35 32 32 35 35 32 35 35 35 35 35 35 32 35 
35 32 32 35 35 32 32 32 32 32 32 32 32 32 32 32 32 32 32 32 32 32 32 32 32 32 32 32 32 32 32 35 35 32 32 35 35 32 32 35 35 32 32 32 35 35 32 32 32 35 
35 32 32 35 35 35 35 35 35 35 35 35 35 35 35 35 35 35 35 35 35 35 35 35 35 35 35 35 35 35 35 35 35 32 32 35 35 32 32 35 35 35 35 32 35 35 32 35 35 35 
35 32 32 32 32 32 32 32 32 32 32 32 32 32 32 32 32 32 32 32 35 35 32 32 32 32 32 32 32 32 32 32 32 32 32 35 35 32 32 35 35 32 32 32 35 35 32 32 32 35 
35 35 35 35 35 35 35 35 35 35 35 35 35 35 35 35 35 35 32 32 35 35 32 32 35 35 35 35 35 35 35 35 35 35 35 35 35 32 32 35 35 32 35 35 35 35 35 35 32 35 
35 32 32 32 32 32 32 32 32 32 32 32 32 32 32 32 32 32 32 32 35 35 35 32 32 35 35 32 32 32 32 32 32 32 32 32 32 32 32 35 35 32 32 32 35 35 32 32 32 35 
35 32 32 35 35 35 35 35 35 35 35 35 35 35 35 35 35 35 35 35 35 35 32 32 35 35 35 32 32 35 35 35 35 35 35 35 35 35 35 35 35 35 35 32 35 35 32 35 35 35 
35 32 32 32 32 32 32 32 32 32 32 32 32 32 32 32 32 32 32 32 35 35 35 32 32 35 35 32 32 35 35 32 32 32 32 32 32 32 32 35 35 32 32 32 35 35 32 32 32 35 
35 35 35 35 35 35 35 35 35 35 35 35 35 35 35 35 35 35 32 32 35 35 32 32 35 35 35 32 32 35 35 32 32 32 35 35 32 32 32 35 35 32 35 35 35 35 35 35 32 35 
35 32 32 32 32 32 32 32 32 32 32 32 32 32 32 32 32 32 32 32 35 35 35 32 32 35 35 32 32 35 35 32 32 32 35 35 32 32 32 35 35 32 32 32 35 35 32 32 32 35 
35 32 32 35 35 35 35 35 35 35 35 35 35 35 35 35 35 35 35 35 35 35 32 32 35 35 35 32 32 35 35 32 32 32 35 35 32 32 32 35 35 35 35 32 35 35 32 32 32 35 
35 32 32 32 32 32 32 32 32 32 32 32 32 32 32 32 32 32 32 32 32 32 32 32 32 35 35 32 32 32 32 32 32 32 35 35 32 32 32 32 32 32 32 32 35 35 32 32 32 35 
35 35 35 35 35 35 35 35 35 35 35 35 35 35 35 35 35 35 35 35 35 35 35 35 35 35 35 35 35 35 35 35 35 35 35 35 35 35 35 35 35 35 35 35 35 35 35 35 35 35 